SO  xpmsprites/redbrick.XPM
WE xpmsprites/colorstone.XPM
EA      xpmsprites/bluestone.XPM
NO    xpmsprites/wood.XPM

F        150   , 150,  150 
C      100   , 100    ,255

1111111111111111
1111111111111111
1111000000011111
1111000000011111
1111000000011111
1111000E00011111
1111000000011111
1111000000011111
1111111011111111
0111111111111111
