NO    xpmsprites/wood.XPM
SO  xpmsprites/redbrick.XPM
WE xpmsprites/colorstone.XPM
EA    xpmsprites/bluestone.XPM

S     xpmsprites/barrel.XPM
F   220,  100,   0
C 225, 30,   0

1111111111111111
1  110001100111 
1111000001000011
   1111002010101111
111100000000000101
100000000000000101111111
1000000000000001000110011
1000000000000001110011001
111000E001111011000110011
1000000000000001000000001
1100000000000000000000001
1000100001111001111111111
1000111110000001
10001 1100001011
11111 111111111 
